A  ##########################################################
      #     #  #  #           #           #        #        #
#  #  ####  #  #  ####  ##########  #  #  #######  #  ####  #
#  #  #  #  #     #           #     #  #  #  #  #     #     #
#  ####  #  #  ####  ####  #############  #  #  ####  ####  #
#  #     #     #     #     #  #                          #  #
#  ####  ####  ####  ####  #  #  #  ####  ####  ####  #  ####
#              #        #     #  #  #     #     #  #  #  #  #
####  #  #  ####  #############  ####  ####  #  #  #  ####  #
#     #  #  #                 #     #     #  #     #        #
#  ####  #  #######  #######  #  ####  #######  #  #######  #
#     #  #  #  #           #  #  #           #  #        #  #
#  #######  #  #######  #############  ####  ####  #  #######
#        #  #        #     #           #     #     #  #     #
####  ####  ####  ####  ##########  ####  ################  #
#     #  #     #  #           #     #     #                 #
#######  #  ####  #  #############  #############  ####  ####
#  #     #           #        #  #           #     #        #
#  #  ####  #######  ####  #  #  #######  #######  ####  #  #
#        #     #     #     #  #        #           #     #  #
#  #  #  #  #  ####  #  #  #  ####  #######  ####  #  #  ####
#  #  #     #  #        #  #  #  #  #  #     #     #  #  #  #
#  #  #######  ####  #######  #  #  #  #  #  #  ####  #  #  #
#  #     #  #  #           #  #     #     #  #  #     #  #  #
#######  #  #  #######  ####  #  #######  #  ##########  #  #
#  #        #  #  #  #     #  #     #     #  #     #        #
#  ####  ####  #  #  #  ####  ####  ####  #######  ##########
#     #  #  #  #  #        #  #           #     #           #
#  #  ####  #  #  #  ################  #  ####  #  #######  #
#  #  #     #  #           #           #              #     #
#  ####  #######  #  ####  #######  ####  ##########  #######
#     #  #  #     #  #     #  #     #        #        #     #
#  ####  #  #  #  #  ####  #  ##########  #  ####  #######  #
#        #     #  #     #        #        #  #           #  #
#  ####  #######  #######  ####  #  #############  ####  #  #
#     #  #        #     #     #  #        #  #  #  #        #
####  ####  #  #  ####  #  #######  #######  #  #  ##########
#     #  #  #  #  #              #  #     #                 #
#  #  #  ##########  #  #  #######  #  ####  #######  ####  #
#  #                 #  #                 #     #     #     
########################################################## B 