###################
#A      #         #
# ##### # ####### #
# #     #     #   #
# # ####### # ### #
# #       # #     #
# ####### ### #####
#       #     #   #
####### ####### ###
#     B         ###
###################
