##########
#A       #
# ###### #
#      #B#
##########
