###################
#A      #         #
# ####### ####### #
#       #     #   #
##### # ##### ### #
#   # #   #       #
# # ### # ##### ###
# #     #     #   #
# ####### ### # ###
#         #B      #
###################
